$ 12 , 26

......#.......#....###....
.####.#.#####.#.###...###.
.#.........#........#.....
.#.#.###...#.######.######
.#.#.#...#.#..#...#.......
...#.#.###.##...#.....####
.#...#...#....#######.....
.###.####..#.#.......####.
.#........##.#.#####......
#..##.###..#.....v...#.##.
#.#.#....#.###########..#.
#....###.#.............#..
