$ 21 , 20

. . . # # # # # # # # # # # # # # # # #
. # . # . . . . . . . . . . . # . . . .
. # . . . # . # # # # # . # . # . # # #
. # . # # # . # . . . # . # . # . . . .
. . . . . # . # . # . # . # . # # # # .
# # # # . . . # # # . # . . . . . . . .
. . . . . # # # . . . . . # . # # # . #
. # # # . # . # # # # # . # . # # # . #
. # . # . . . . . . . . . . . . . # . #
. # . # # # # # # # # . # # # # . # . #
. # . . . # . . . . # . # . . . . . . #
. # # # . # . # # # # . # . # # . # # #
. . . . . # . # # # # . # . . # . # . .
. # # # # # . . . . . . # # . # . # . #
. . . . . # # . # # # . # # . # . # . .
. # # # . . . . . . . . # # . # . # # .
. # . # # # # # # # . . . . . # . . . .
. # . . . . # . # # . # # # . # # # # .
. # # . # . # . . . . # # # . . . . # .
. # # . # . # . # # # # v # . # # # # .
. . . . # . . . . . . . . # . . . . . .


. . . # # # # # # # # # # # # # # # # #