$ 40 , 40

. . # # . . . . # . . . . . # . . . . . . # . . . . . . . # # # # # # . . . # # 
# . . . . # # . # . # # # . # . # # # # # # . # # # # # . . . . . . . . # . . # 
# # # # . # # # # . . . # . . . . . . . . . . . . # # # # # # # # . # # # # # # 
. . . . . . . . . . # # # # # . # # . # . # . # . . . . . . . . # . . . . . . # 
. # . # # # # # # # # . . . # . . . . # . # . # # # # # # # # # # . # # # # . # 
. # . . . . . . . . . . # # # . # # # # . # . # . . . . . . . . # . . . . # . # 
. # # # # # # . # . # # # . . . . . . . . # . # . # # # # # # . # # # # # # . # 
. . . . . . # . # . # . # . # . # . # # # # . # . # . . . . # . # . . . . . . # 
# # . # # . # # # . # . # . # . # . . . . # . # . # . # # # # . # . # . # # . # 
. . . # # . . . . . # . . . # . # . # # . # . . . # . . . . . . # . # . # . . # 
. # . # # # # # # # # # # # # . # . # . . # # # . # # # # # # # # . # . # # # # 
. # . # # # # . . . . . . . . . # . # . # # . . . . . . . # . . . . # . . . . . 
. # . . . . . . # . # # # # # . # . # . # # # # . # . # . # # # # # # . # # # . 
. # # # # # # # # . # # . . . . . . # . . . . . . # . # . . . . . . . . # . # . 
. # . . . . . . # . . # # # # # # . # # # . # # . # # # # # # # # . # . # . # . 
. # . # # . # . # # . # . . . . . . . . . . . # . . . . . . . # # . # . . . # . 
. . . . # . # . . . . # . # # # # # # # # # # # . # # # . # . . . . # # # # # . 
# # # # # . # # # # # # . . . . . . . . . . . . . # . . . # . # # # # . . . . . 
# . . . . . . . . . . # # . . . # # # . # # # # . # . # . # . . . . # . # . # . 
# # # # # # # # . # . # # . # . # . # . . . # # . # . # . # # # # . . . # . # . 
. . . # . . . # . # . # # . # . # . # . # . # # . # . # . . . . # # # # # . # # 
. # . # . # . # . # . . . . # . . . # . # . . # # # . # # # # . . . . . . . . # 
. # . # . # . # . # . # # # # # # # # . # # . . . . . . . . # . # . # # # # # # 
. # . # . # . . . # . # . . . . . . . . . # # # # # . # # # # . # . . . . . . . 
. # # # . # . # # # . # # # . # # # # # . . . . . . . . . . . . # . # # # # # . 
. . . . . # . . . . . # . . . . . . . # # . # . # # # # # # # . # . # . . . # . 
# # # # . # # # . # . # . # . # # # . . # . # . . . . . . . # . # . # . # # # . 
. . . . . . . . . # . # . # . # # # # . # . # # # # # # # . # . . . . . # . . . 
. # . # . # # # # # . # . # . . . . # . . . # . . . . . # . # . . . # . # . # # 
. # . # . . . . . # . # # # # # # . # # # # # . # # # . # . # . # # # # # . . . 
. # . # # # # # . # . . . . . . . . . . . . . . . . # . . . # . # . . . # # # . 
. # . . . . . # . # . # . # . # # # # # # # . # # # # # # # # . # . # . . . . . 
. # # # # # . # . # . # . # . . . . . . . # . # # . . . . . . . # . # . # # # # 
. . . . . . . . . # # # . # # # # # # # . # . # # . # # # # # . # . # . . . . . 
# # # # . # . # . . . . . # . . . . . # . # . . . . # # # # # . # # # . # . # . 
. # . # . # . # . # # # . # . # # # # # . # . # # . . . . . . . # . . . # . # . 
. # . # # # . # . # . # . # . # # # # # . # . # # # # # # . # # # . # # # . # . 
. # . . . . . # . # . . . # . . . . . . . # . . . # . . # . # . . . # v . . # . 
. # # # # # . # . # # # # # # # # # # # # # . # . # # . # . # # # # # . # # # . 
. . . . . . . # . . . . . . . . . . . . . . . # . . . . # . . . . . . . # . . . 


